{
  "en_to_ru": {
    "`": "ё",
    "1": "1",
    "2": "2",
    "3": "3",
    "4": "4",
    "5": "5",
    "6": "6",
    "7": "7",
    "8": "8",
    "9": "9",
    "0": "0",
    "-": "-",
    "=": "=",
    "q": "й",
    "Q": "Й",
    "w": "ц",
    "W": "Ц",
    "e": "у",
    "E": "У",
    "r": "к",
    "R": "К",
    "t": "е",
    "T": "Е",
    "y": "н",
    "Y": "Н",
    "u": "г",
    "U": "Г",
    "i": "ш",
    "I": "Ш",
    "o": "щ",
    "O": "Щ",
    "p": "з",
    "P": "З",
    "[": "х",
    "]": "ъ",
    "\\": "ё",
    "a": "ф",
    "A": "Ф",
    "s": "ы",
    "S": "Ы",
    "d": "в",
    "D": "В",
    "f": "а",
    "F": "А",
    "g": "п",
    "G": "П",
    "h": "р",
    "H": "Р",
    "j": "о",
    "J": "О",
    "k": "л",
    "K": "Л",
    "l": "д",
    "L": "Д",
    ";": "ж",
    "'": "э",
    "z": "я",
    "Z": "Я",
    "x": "ч",
    "X": "Ч",
    "c": "с",
    "C": "С",
    "v": "м",
    "V": "М",
    "b": "и",
    "B": "И",
    "n": "т",
    "N": "Т",
    "m": "ь",
    "M": "Ь",
    ",": "б",
    ".": "ю",
    "/": ".",
    "|": "Ё"
  },
  "ru_to_en": {
    "ё": "`",
    "Ё": "`",
    "1": "1",
    "2": "2",
    "3": "3",
    "4": "4",
    "5": "5",
    "6": "6",
    "7": "7",
    "8": "8",
    "9": "9",
    "0": "0",
    "-": "-",
    "=": "=",
    "й": "q",
    "Й": "Q",
    "ц": "w",
    "Ц": "W",
    "у": "e",
    "У": "E",
    "к": "r",
    "К": "R",
    "е": "t",
    "Е": "T",
    "н": "y",
    "Н": "Y",
    "г": "u",
    "Г": "U",
    "ш": "i",
    "Ш": "I",
    "щ": "o",
    "Щ": "O",
    "з": "p",
    "З": "P",
    "х": "[",
    "Х": "[",
    "ъ": "]",
    "Ъ": "]",
    "\\": "\\",
    "ф": "a",
    "Ф": "A",
    "ы": "s",
    "Ы": "S",
    "в": "d",
    "В": "D",
    "а": "f",
    "А": "F",
    "п": "g",
    "П": "G",
    "р": "h",
    "Р": "H",
    "о": "j",
    "О": "J",
    "л": "k",
    "Л": "K",
    "д": "l",
    "Д": "L",
    "ж": ";",
    "Ж": ";",
    "э": "'",
    "Э": "'",
    "я": "z",
    "Я": "Z",
    "ч": "x",
    "Ч": "X",
    "с": "c",
    "С": "C",
    "м": "v",
    "М": "V",
    "и": "b",
    "И": "B",
    "т": "n",
    "Т": "N",
    "ь": "m",
    "Ь": "M",
    "б": ",",
    "Б": ",",
    "ю": ".",
    "Ю": ".",
    ".": "/"
  }
}